xxxxxxxxxxxxxxxxxxxx
x..................x
x....xxx...xxx.....x
x...x...x.x...x....x
x..................x
x....x.......x.....x
x.....x.....x......x
x......x...x.......x
x..................x
x........x.........x
x..................x
xxxxxxxxxxxxxxxxxxxx
