xxxxxxxxxxxxxxxxxxxx
x..................x
x..xxx...xx...xxx..x
x..x............x..x
x..x............x..x
x........xx........x
x........xx........x
x..x............x..x
x..x............x..x
x..xxx...xx...xxx..x
x..................x
xxxxxxxxxxxxxxxxxxxx
