xxxxxxxxxxxxxxxxxxxx
x..................x
x..................x
x..................x
x.....xxx..xxx.....x
x....x........x....x
x....x........x....x
x....xx......xx....x
x.....xx....xx.....x
x..................x
x..................x
xxxxxxxxxxxxxxxxxxxx
