xxxxxxxxxxxxxxxxxxxx
x..................x
x..................x
x....xxx....xxx....x
x....x........x....x
x.....x......x.....x
x......x....x......x
x.......x..x.......x
x...xxxxx..xxxxx...x
x..................x
x..................x
xxxxxxxxxxxxxxxxxxxx
