xxxxxxxxxxxxxxxxxxxx
x..................x
x..................x
x......xxxxx.......x
x..................x
x..................x
x....xx.....xx.....x
x......x...x.......x
x.......x.x........x
x........x.........x
x..................x
xxxxxxxxxxxxxxxxxxxx
